is	are
its	their
life	lives
the	 
it	them
wolf	wolves
man	men
child	children
shed	shedim
lioness	lionesses
magus	magi
sorceress	sorceresses
hero	heroes
lich	liches
witch	witches
ker	keres
khalkotauros	khalkotauroi
lampad	lampades
otherness	othernesses
vastness	vastnesses